FAJ = "countries/Finn and Jake.txt"
MAR = "countries/Marseline Vampire.txt"
ASH = "countries/Ashe house.txt"
PBB = "countries/Princess Bonnebel Bublegum.txt"
NUT = "countries/Nuts kingdom.txt"
IKK = "countries/Ice king kingdom.txt"
GLK = "countries/graph lemon kingdom.txt"
COM = "countries/City of mages.txt"
BEK = "countries/Berry kingdom.txt"
MOF = "countries/MO factory.txt"
FIK = "countries/Fire kingdom.txt"
BAG = "countries/Bandits gang.txt"
BGT = "countries/Bandits gang two.txt"
BGH = "countries/Bandits gang three.txt"
BIL = "countries/Billy.txt"
BML = "countries/Bananaman laboratory.txt"
CBK = "countries/Cats boxes kingdom.txt"
BOV = "countries/Box village.txt"
COT = "countries/City of thief.txt"
COW = "countries/Crazy old woman.txt"
CPD = "countries/Crazy pie deliverman.txt"
CRP = "countries/crab princess.txt"
CSM = "countries/Crazy shootgun man.txt"
CWM = "countries/Crazy wizzard man.txt"
BRK = "countries/breakfast kingdom.txt"
DTV = "countries/Desert thieves.txt"
DBL = "countries/Dancing bears lands.txt"
DRG = "countries/Dragon.txt"
DED = "countries/undead.txt"
DAF = "countries/Dark forest.txt"
DTT = "countries/Desert thieves two.txt"
DTH = "countries/Desert thieves two three.txt"
DTF = "countries/Desert thieves four.txt"
DPB = "countries/Desert Pirate Bay.txt"
DPT = "countries/Desert Pirate Bay two.txt"
DPH = "countries/Desert Pirate Bay three.txt"
DPF = "countries/Desert Pirate Bay four.txt"
DWC = "countries/Desert workers city.txt"
TEP = "countries/Technoprintess.txt"
EVF = "countries/evil fairies.txt"
SKE = "countries/Skelet princess.txt"
FDG = "countries/Father dungeon.txt"
FGS = "countries/Forest of giant spiders.txt"
FHW = "countries/Forest Huntress mage.txt"
FHL = "countries/Fish human lands.txt"
FDM = "countries/Forest of druid mage.txt"
FAI = "countries/island.txt"
FIT = "countries/island two.txt"
FIH = "countries/island three.txt"
FLM = "countries/Fat little mans.txt"
FTQ = "countries/Forest temple.txt"
FOX = "countries/Foxes den.txt"
FWL = "countries/Fire wolve.txt"
FUZ = "countries/fuzzies.txt"
GAD = "countries/Gladiator Arena.txt"
GOP = "countries/Godpartyes.txt"
GSN = "countries/Giant snails.txt"
GFR = "countries/Giant frog.txt"
GOK = "countries/Goblins kingdom.txt"
HDL = "countries/Hot dog land.txt"
HOS = "countries/World hospital.txt"
HSH = "countries/herbal Sorcerer house.txt"
IFI = "countries/land of intelligent fish.txt"
KNG = "countries/Knights Guild.txt"
LIB = "countries/library territory.txt"
LRH = "countries/Lady Rainicorn home.txt"
MCL = "countries/mountain cyclops land.txt"
MHV = "countries/Mashroom village.txt"
MFT = "countries/Master farm territory.txt"
MPK = "countries/Muscle princess kingdom.txt"
MTW = "countries/Maya the witch.txt"
OLD = "countries/Starche.txt"
NWD = "countries/nuclear waste dump.txt"
OAK = "countries/Oak of owl.txt"
OBW = "countries/Old bold witch.txt"
SLO = "countries/slime oasis.txt"
PGM = "countries/Pogremushkin.txt"
PFV = "countries/prickly folk village.txt"
PEA = "countries/Peaseful village.txt"
PVT = "countries/Peaseful village two.txt"
PVH = "countries/Peaseful village three.txt"
PVF = "countries/Peaseful village four.txt"
PVI = "countries/Peaseful village five.txt"
PVS = "countries/Peaseful village six.txt"
PHL = "countries/Pretty humans lands.txt"
PSG = "countries/Pale satan gang.txt"
PPK = "countries/Princess of Pimple kingdom.txt"
RIV = "countries/River village.txt"
SGL = "countries/Snow Golem lands.txt"
PWH = "countries/picewood home.txt"
SKL = "countries/Stone keeper lands.txt"
EGN = "countries/Evil gnoms.txt"
MRO = "countries/Market robbers.txt"
SOM = "countries/school of mages.txt"
SOK = "countries/Strange old kingdom.txt"
SMM = "countries/Sad music man.txt"
STW = "countries/Stanley watermelon.txt"
SVS = "countries/Snakes vampires sananists.txt"
SPF = "countries/Super pore factory.txt"
TGA = "countries/Temple of great armor.txt"
THV = "countries/Talking houses village.txt"
SWV = "countries/Sweet village.txt"
TMT = "countries/Trade markets territory.txt"
UWK = "countries/underground walnut kingdom.txt"
WAL = "countries/Warriors lands.txt"
ZHH = "countries/Zhermen house.txt"
WWL = "countries/Way wolves lands.txt"
WST = "countries/whistler land.txt"
WOL = "countries/Wild wolves.txt"
WLT = "countries/Wild wolves two.txt"
WLR = "countries/Wild wolves three.txt"
WOI = "countries/Woman island.txt"
PIB = "countries/Pirate Bay.txt"
PBT = "countries/Pirate Bay two.txt"
PBR = "countries/Pirate Bay three.txt"
DEN = "countries/Dentist.txt"
BAP = "countries/Banana pirats.txt"
RCM = "countries/Rock candy mines.txt"
MMO = "countries/Matphei mountain.txt"
BRZ = "countries/Breezy.txt"
BHP = "countries/Bounce House Princess.txt"
EMP = "countries/Emerald princess lands.txt"
RAG = "countries/Raggedy Princess.txt"
HUW = "countries/Hug Wolves.txt"
DEM = "countries/Fathers demons.txt"
DEC = "countries/Desert city.txt"
DCT = "countries/Desert city two.txt"
NWZ = "countries/nuclear waste zone.txt"
MSH = "countries/Giant mashrooms.txt"
KEN = "countries/Kenion.txt"
DGT = "countries/Dragon two.txt"
DGH = "countries/Dragon three.txt"
SEK = "countries/Sea kingdom.txt"
DPA = "countries/Desert Pirate Army.txt"
DPO = "countries/Desert Pirate Army two.txt"
DPE = "countries/Desert Pirate Army three.txt"
ELB = "countries/Elbow Princess.txt"
JUN = "countries/Jungle princess.txt"
PUR = "countries/Purple princess.txt"
RPC = "countries/Ring princess.txt"
LIC = "countries/Lich.txt"
GLA = "countries/Glass kingdom.txt"
ICL = "countries/Icecream lands.txt"
TMK = "countries/Tiny mammal kingdom.txt"
BLE = "countries/BLE country.txt"